1 1 1 1 1 1 1 1 1 1 1 1 1 1 1
1 0 0 0 0 0 0 1 0 0 0 0 0 0 1
1 0 0 1 1 0 0 0 0 0 1 1 0 0 1
1 1 0 0 0 0 1 1 1 0 0 0 0 1 1
0 1 0 1 0 0 0 1 0 0 0 1 0 1 0
1 1 0 1 1 0 0 0 0 0 1 1 0 1 1
0 0 0 1 0 0 1 0 1 0 0 1 0 0 0
1 1 0 0 0 0 1 1 1 0 0 0 0 1 1
0 1 0 1 0 0 0 1 0 0 0 1 0 1 0
1 1 0 1 0 0 0 0 0 0 0 1 0 1 1
1 0 0 0 0 0 1 1 1 0 0 0 0 0 1
1 0 0 0 0 0 0 1 0 0 0 0 0 0 1
1 1 1 1 1 1 1 1 1 1 1 1 1 1 1

legenda: 1 = parede; 0 = caminho livre;